###                 #########
#   ########### #######   # #
# ####                #   # #
# ###### ############ #   # #
#                     #   # #
###### ############## #   # #
#      #              #   # #
# # # ############# ###   # #
# #        ##B          # # #
# # ################### # # #
### ##                  # # #
### ############## ## # # # #
###             ##    # # # #
###### ######## ####### # # #
###### ####             #   #
A      ######################